3 8 8 8 8 8 8 8 8 8 8 8 8 4 8 8 8 8 8 8 8 8 8 8 8 8 5
16 11 11 11 11 11 11 11 11 11 11 11 11 16 11 11 11 11 11 11 11 11 11 11 11 11 16
16 11 0 1 1 2 11 0 1 1 1 2 11 16 11 0 1 1 1 2 11 0 1 1 2 11 16
16 11 10 11 11 12 11 10 11 11 11 12 11 16 11 10 11 11 11 12 11 10 11 11 12 11 16
16 11 20 21 21 22 11 20 21 21 21 22 11 26 11 20 21 21 21 22 11 20 21 21 22 11 16
16 11 11 11 11 11 11 11 11 11 11 11 11 11 11 11 11 11 11 11 11 11 11 11 11 11 16
16 11 7 8 8 9 11 6 11 7 8 8 8 4 8 8 8 9 11 6 11 7 8 8 9 11 16
16 11 11 11 11 11 11 16 11 11 11 11 11 16 11 11 11 11 11 16 11 11 11 11 11 11 16
23 8 8 8 8 5 11 13 8 8 8 9 11 26 11 7 8 8 8 15 11 3 8 8 8 8 25
11 11 11 11 11 16 11 16 11 11 11 11 11 11 11 11 11 11 11 16 11 16 11 11 11 11 11
8 8 8 8 8 25 11 26 11 0 1 1 1 11 1 1 1 2 11 26 11 23 8 8 8 8 8
11 11 11 11 11 11 11 11 11 10 11 11 11 11 11 11 11 12 11 11 11 11 11 11 11 11 11
8 8 8 8 8 5 11 6 11 20 21 21 21 21 21 21 21 22 11 6 11 3 8 8 8 8 8
11 11 11 11 11 16 11 16 11 11 11 11 11 11 11 11 11 11 11 16 11 16 11 11 11 11 11
3 8 8 8 8 25 11 26 11 7 8 8 8 4 8 8 8 9 11 26 11 23 8 8 8 8 5
16 11 11 11 11 11 11 11 11 11 11 11 11 16 11 11 11 11 11 11 11 11 11 11 11 11 16
16 11 7 8 8 5 11 7 8 8 8 9 11 26 11 7 8 8 8 9 11 3 8 8 9 11 16
16 11 11 11 11 16 11 11 11 11 11 11 11 11 11 11 11 11 11 11 11 16 11 11 11 11 16
13 8 8 9 11 26 11 6 11 7 8 8 8 4 8 8 8 9 11 6 11 26 11 7 8 8 15
16 11 11 11 11 11 11 16 11 11 11 11 11 16 11 11 11 11 11 16 11 11 11 11 11 11 16
16 11 7 8 8 8 8 24 8 8 8 9 11 26 11 7 8 8 8 24 8 8 8 8 9 11 16
16 11 11 11 11 11 11 11 11 11 11 11 11 11 11 11 11 11 11 11 11 11 11 11 11 11 16
23 8 8 8 8 8 8 8 8 8 8 8 8 8 8 8 8 8 8 8 8 8 8 8 8 8 25
